00000000
01040000
00000220
00000220
50000000
00000030
30000000
00000000