00000000
03000030
00000000
00204000
00006000
00000000
00000000
00000000