00000000
50000000
00000300
03000000
01000060
00020000
00000000
00000000