00000000
60000050
00000000
00012060
03002000
00000000
00000000
00000000