00000000
00601200
00000200
05000200
00000200
00600000
00000000
00000000