00000000
01040000
00022220
00000000
50000000
00000000
30000000
00000000