00000000
50000000
00000300
03020000
00020050
01020000
00000000
00000000