00000050
50000000
00010000
00002050
03002000
00000000
00000000
00000000