05000000
00001200
06000200
00000200
05000200
00000000
00000000
00000000